1111111111111111121111111111111
2222222212222222121222221222221
1111111112222222121222221212221
1222222222222222122222221212221
1211111111111111111111111212221
1212222122222222222222222212221
1212222122222222222211111112111
1212222122222222222212222212122
1212222122222222222212122212121
1212222122222222222212122212121
1212111122222222222212122212121
1212222222222222222212122212121
1211111111111111111112122211121
1222222222221222221212122212221
1111111111121233321212122212221
2222221222221233321212122212221
1222221211111233321212122212221
1222221212222222111212122212221
1111111212111111111212122212221
1222222212222222222222122212221
1211111111111111121111111111111
1212222222222222121222222222221
1212222222222222121222222222221
1212222222222222121222222222221
1211111111111111111211111111111
1222222222122222221222222222222
1222222222122222221111111111111
1222222222222222222222222222221
1111111111111111111111111112221
1222221222222222222222222212221
1222221111111111121111111111111